11111111111111111111111111111111111
111111900H00J0000000000G00111111111
111111000000000000K0000000111111111
11111100K0000000000000M000111111111
11111100000000000000000J00111111111
1111110000000000000J000000111111111
22222222222222223332222222222222222
23333333333333333333M33333333333M32
23222222222222223332222222222222232
2333333333333333T333333333333332232
23222222322222222232H22222232322232
23333K32333J333333333J3333332J33332
23232222322222222322222222222322232
23233333333332222333333333333322232
2322222322222P222222232222222222232
2333T33323333333J33333333333T322232
23222222232222222222222222222333232
23333333332222222233333332222333332
22222222222222222222222222222222222
