111111111111111
190000000000001
100000000000001
100000J00000001
100000000000001
1000000000000P1
111111111111111