11111111111111111111111111111111111
10000000000J00000000000J00000000001
100000J00000000000J0000000000000001
100J0000000J00000000000000009000001
11111111111100000000000111111111111
1111111111110000000000J111111111111
22222222222223223222322222222222222
23333333333333333333333333333333332
23222222222222223332222222222222232
23333333333333333333333333333332232
23222222322222222232222222232322232
23333332333333333333333333332333332
23232222322222222322222222222322232
23233333333332222333333333333322232
23222223222222222222232222222222232
23333333233333333333333333333322232
23222222232222222222222222222333232
23333333332222222233333332222P23332
22222222222222222222222222222222222
