11111111111111111
19000000000000001
10000000J00000001
10002222222200001
10002300000320001
10002300000320001
10002222222200001
10000000000000001
10000H000000A0001
10000000J00000001
100000000000000P1
11111111111111111