11111111111111111111111111111111111
1111111111110T00J000000000000000091
111111111111000J00J0001111111111111
111111111111K000H0000J1111111111111
11111111111100T00J00001111111111111
111111111111000J000J001111111111111
22222222222222222222232222222222222
2333333333J333333J33333333333333332
23222222222222223332222222222222232
2333G33333J3333333333333333333322J2
23222222322222222232222222232322232
2J33333233333J333333333K33332333332
23232222322222222322222222222322232
232333333333322223333333M3333322232
2322222322222H2222222322222222222J2
23M33333233333333J33333333333K22232
23222222232222222222222222222333232
233G33333P2222222233333332222333332
22222222222222222222222222222222222
